15 12
300 600
3 1 1 1 1 1 1 1 1 1 1 1 1 1 4
3 6 6 6 6 6 6 6 6 6 6 6 6 6 4
3 0 0 0 0 0 0 0 0 0 0 0 0 0 4
3 0 0 0 0 0 0 0 0 0 0 0 0 0 4
3 0 0 0 0 0 0 0 0 0 0 0 0 0 4
3 0 0 0 0 0 0 0 0 0 0 0 0 0 4
3 1 1 1 1 0 0 0 0 0 1 1 1 1 4
3 6 6 6 6 0 0 0 0 0 6 6 6 6 4
3 0 0 0 0 0 0 0 0 0 0 0 0 0 4
3 0 0 0 0 0 0 0 0 0 0 0 0 0 4
3 0 0 0 0 0 0 0 0 0 0 0 0 0 4
2 5 5 5 5 5 5 5 5 5 5 5 5 5 2