8 12
300 450
3 1 1 1 1 1 1 4
3 6 6 6 6 6 6 1
3 0 0 0 0 0 0 6
3 0 0 0 0 0 0 0
3 0 0 0 0 0 0 0
3 0 0 0 0 0 0 4
3 1 1 1 1 0 0 4
3 6 6 6 6 0 0 4
3 0 0 0 0 0 0 4
3 0 0 0 0 0 0 4
3 0 0 0 0 0 0 4
2 5 5 5 5 5 5 2
res/worlds/world1Entities.txt